Arteriviridae	ssRNA
Coronaviridae	ssRNA
Mesoniviridae	ssRNA
Roniviridae	ssRNA
Dicistroviridae	ssRNA
Iflaviridae	ssRNA
Marnaviridae	ssRNA
Picornaviridae	ssRNA
Secoviridae	ssRNA
Alphaflexiviridae	ssRNA
Betaflexiviridae	ssRNA
Gammaflexiviridae	ssRNA
Tymoviridae	ssRNA
Alphatetraviridae	ssRNA
Alvernaviridae	ssRNA
Astroviridae	ssRNA
Barnaviridae	ssRNA
Benyviridae	ssRNA
Bromoviridae	ssRNA
Caliciviridae	ssRNA
Carmotetraviridae	ssRNA
Closteroviridae	ssRNA
Flaviviridae	ssRNA
Fusariviridae	ssRNA
Hepeviridae	ssRNA
Hypoviridae	ssRNA
Leviviridae	ssRNA
Luteoviridae	ssRNA
Polycipiviridae	ssRNA
Narnaviridae	ssRNA
Nodaviridae	ssRNA
Permutotetraviridae	ssRNA
Potyviridae	ssRNA
Sarthroviridae	ssRNA
Statovirus	ssRNA
Togaviridae	ssRNA
Tombusviridae	ssRNA
Virgaviridae	ssRNA
Sarthroviridae	ssRNA
Alphatetraviridae	ssRNA
Alvernaviridae	ssRNA
Astroviridae	ssRNA
Barnaviridae	ssRNA
Benyviridae	ssRNA
Bromoviridae	ssRNA
Caliciviridae	ssRNA
Carmotetraviridae	ssRNA
Closteroviridae	ssRNA
Flaviviridae	ssRNA
Hepeviridae	ssRNA
Leviviridae	ssRNA
Luteoviridae	ssRNA
Narnaviridae	ssRNA
Nodaviridae	ssRNA
Permutotetraviridae	ssRNA
Potyviridae	ssRNA
Sarthroviridae	ssRNA
Solemoviridae	ssRNA
Solinviviridae	ssRNA
Togaviridae	ssRNA
Tombusviridae	ssRNA
Virgaviridae	ssRNA
Qinviridae	ssRNA
Aspiviridae	ssRNA
Chuviridae	ssRNA
Bornaviridae	ssRNA
Filoviridae	ssRNA
Mymonaviridae	ssRNA
Nyamiviridae	ssRNA
Paramyxoviridae	ssRNA
Pneumoviridae	ssRNA
Rhabdoviridae	ssRNA
Sunviridae	ssRNA
Yueviridae	ssRNA
Arenaviridae	ssRNA
Cruliviridae	ssRNA
Feraviridae	ssRNA
Fimoviridae	ssRNA
Hantaviridae	ssRNA
Jonviridae	ssRNA
Nairoviridae	ssRNA
Peribunyaviridae	ssRNA
Phasmaviridae	ssRNA
Phenuiviridae	ssRNA
Tospoviridae	ssRNA
Orthomyxoviridae	ssRNA
Amnoonviridae	ssRNA
Myoviridae	dsDNA
Podoviridae	dsDNA
Siphoviridae	dsDNA
Alloherpesviridae	dsDNA
Herpesviridae	dsDNA
Malacoherpesviridae	dsDNA
Lipothrixviridae	dsDNA
Rudiviridae	dsDNA
Adenoviridae	dsDNA
Ampullaviridae	dsDNA
Ascoviridae	dsDNA
Asfarviridae	dsDNA
Baculoviridae	dsDNA
Bicaudaviridae	dsDNA
Clavaviridae	dsDNA
Corticoviridae	dsDNA
Fuselloviridae	dsDNA
Globuloviridae	dsDNA
Guttaviridae	dsDNA
Hytrosaviridae	dsDNA
Iridoviridae	dsDNA
Lavidaviridae	dsDNA
Marseilleviridae	dsDNA
Mimiviridae	dsDNA
Nudiviridae	dsDNA
Nimaviridae	dsDNA
Pandoraviridae	dsDNA
Papillomaviridae	dsDNA
Phycodnaviridae	dsDNA
Plasmaviridae	dsDNA
Polydnaviruses	dsDNA
Polyomaviridae	dsDNA
Poxviridae	dsDNA
Sphaerolipoviridae	dsDNA
Tectiviridae	dsDNA
Tristromaviridae	dsDNA
Turriviridae	dsDNA
Lavidaviridae	dsDNA
Anelloviridae	ssDNA
Bacilladnaviridae	ssDNA
Bidnaviridae	ssDNA
Circoviridae	ssDNA
Geminiviridae	ssDNA
Genomoviridae	ssDNA
Inoviridae	ssDNA
Microviridae	ssDNA
Nanoviridae	ssDNA
Parvoviridae	ssDNA
Smacoviridae	ssDNA
Spiraviridae	ssDNA
Matonaviridae	ssRNA
Xinmoviridae	ssRNA
ï»¿Pleolipoviridae	dsDNA
Chrysoviridae	dsRNA
Amalgaviridae	dsRNA
Birnaviridae	dsRNA
Euroniviridae	ssRNA
Retroviridae	ssRNA